213
3000000000000000000000000000000000000000000000000000000000000000000000000000000000000000000000000000000000000000000000000000000000000000000000000000000000000000000000000000000000000000000000000000000000000000000003
3000000000000000000000000000000000000000000000000000000000000000000000000000000000000000000000000000000000000000000000000000000000000000000000000000000000000000000000000000000000000000000000000000000000000000000003
3000000000000000000000000000000000000000000000000000000000000000000000000000000000000000000000000000000000000000000000000000000000000000000000000000000000000000000000000000000000000000000000000000000000000000000003
3000000000000000000000000000000000000000000000000000000000000000000000000000000000000000000000000000000000000000000000000000000000000000000000000000000000000000000000000000000000000000000000000000000000000000000003
3000000000000000000000000000000000000000000000000000000000000000000000000000000000000000000000000000000000000000000000000000000000000000000000000000000000000000000000000000000000000000000000000000000000000000000003
3000000000000000000000000000000000000000000000000000000000000000000000000000000000000000000000000000000000000000000000000000000000000000000000122100000000000000000000000000000000000000000000000000000000000000000003
3000000000000000002000000000000000000000000000000000000000000000000000000000000000121000000000000000000000000000000000000000000000000000000000000000000000000000000000000000000000066000000000000000000000000000000003
3000000000000000000000000000000000000000000000000000000000000000000000000000000000000000000000002000000000000000000000000000000000000000000000000000000000000000000000000000000006666000000022000000000000000000000003
3000000200000000000000000000000000000000000002222200000000000000000000001111100100000000000000000000000000000000000111000012210000000000002000666600000000000000000000000000000066666000000000000000000000000000000003
3000000000060000011110000000000000000000000000000000000000000000000000000000000000111000600000060600000000000000000000000000000000000000000006000000000000000000000000000000000666666111000000000000000000000000000003
3000000000660060000000000000000000000000000000000000606000000000000000000000000000000006600000660000000000002000000000000000000000600600000060066006000000000000000000000000006666660000000111000000000000000000900003
3000001210000660020000000000000000000000000002222200000600000000022220000222000000000060000111660200002020000000010000000062200006600660006666666666660000000000011200000000066666666000111006000000000000000009990003
3000000000006660000000066000000000000000000000000000000006000000000000000000000000006660000000000000000000000000000000006660000066600666000000666666666000000000000000000000666666666000000006000000000000000099999003
304000000006666500000566600G00000G000006006000G00000G000600000000000000000000000000666650000000050600000000060005006006666600G06666TT66666TTTT6666666666600000G0000000T00006666666666TTTTTTTT605000G000050000999899903
3333333333333333333333333333333333333333773333333333333333333773333333333333330333333333333333333337733333TT33333333TT333333333333333333333333333333333333333333333333333333333333333333333333333333333333333333333333
3333333333333333333333333333333333333333333333333333333333333333333333333333337333333333333333333333333333333333333333333333333333333333333333333333333333333333333333333333333333333333333333333333333333333333333333